#####......######################
####.........###.......##########
##########.......####......######
####.......###.....##..##......##
##....#....##.....###.........###
##...##...#####.......####....###
###...###....##...###...###....##
####..######....###...####....###
####...######...#.....####..#####
#####..............##.......#####
###########################..####
\robot 9 1
\robot 28 3
