###########
..........#
.######....
..###......
.###......#
.##########
###########
\robot 1 3
\robot 4 2
\robot 9 4
